11111111111111111111
1E1P1000010100011111
10101000101000011101
1C1000000001000111C1
10000000000C10011101
10001010000100000101
10001C10000000110001
11111111111111111111