111111111111111111111
1E1P10000101000111111
101010001010000111101
1C10000000010001111C1
10000000000C100111101
100011100001000000101
10001C100000000110001
111111111111111111111