11111111
100000001
10E000C01
1000000001
1011100P01
1111111111