111111111111
1000000000P1
1000000C0001
100EE0000001
111111111111